spike on top - kolec na czubku
shallow - płytki
seal - pieczęć
Dont make such a ratchet - Nie rób takiego hałasu
cancel an appointment - odwołać wizytę
hoarder - zbieracz
purge - czyścić, oczyszczać
swamp - bagno
bread - chleb
cloth - tkanina
suffocated - uduszony
ordinary - zwykły
got ripped out of me - został ze mnie wyrwany
may not occur - mogą nie występować
abducted - uprowadzony
strangle - udusić
convicted - skazany
resoname gauge - wskaźnik rezonansu
broad concept - szeroka koncpecja
commuting - dojazdy
breach - naruszenie
susceptible - podatny
anxiety - niepokój
virtually - praktycznie prawie wszyscy
apply - zastosowanie, stosować
fool myself - oszukiwać siebie
unaware - nieświadomy
allthough - Chociaż
avid - zapalony
afford - pozwolić sobie
offended - obrażony
afforded - zapewniany, przyznany
emphasasis - nacisk, podkreślenie
gonna crush - zmiażdzyć
get after him - goń go
bolted - przykręcony
circumstances - okoliczności
involve - obejmują

