either way - tak czy inaczej
donor - dawca
discharged - zwolniony
right femur - prawa kość udowa
fracture - złamanie
admit - przyznać
grudge - uraz 
corpse - zwłoki 
blooming red - kwitnąca czerwień
stall - stragan, stoisko
I can relate - Mogę się zgodzić
wipe - wytarty, przetarty
restroom - toaleta
That's definetely odd - To dziwne
equivelant to - odpowiednik
couldnt resist - Nie mogłem się oprzeć
proceed - kontynuować
according to - zgodnie z
track record - osiągnięcia
sue - pozwać
approach - metoda
associate - współpracownicy
obvious - oczywisty
settle - załatwić
wittness - świadek 
proof - dowód
proofed - zabezpieczony, zaimpregnowany
cut to the bone - obcięte do minimum
commit - popełnić
market - rynek
cure for everything - lek na wszystko
discouraged me - zniechęciło mnie
inherit - odziedziczyć
i know so - Ja to wiem 
transmit - transmitować, przesyłać
commence - rozpoczynać
beyond solution - poza standardem
atop - na szczycie

